####################################
#H              T            P     #
# # #  ## ## ##### # #### ### ## # #
# # ## #  ##  ###  ## ## ## # # ## #
# #  # #  ###  # # ### #####  ###  #
#                                  #
# # ##  # ## ##### # #### ### ## # #
# # #  ## ##  ###  ## ## ## # # ## #
# # ##  # ###  # # ### #####  ###  #
#                                  #
# # ##  # ## ##### # #### ### ## # #
# # #  ## ##  ###  ## ## ## # # ## #
# # ##  # ###  # # ### #####  ###  #
#                                  #
# # ##  # ## ##### # #### ### ## # #
# # #  ## ##  ###  ## ## ## # # ## #
# # ##  # ###  # # ### #####  ###  #
#                                  #
# # ##  # ## ##### # #### ### ## # #
# # #  ## ##  ###  ## ## ## # # ## #
# # ##  # ###  # # ### #####  ###  #
#                        $         #
####################################