####################################
#      #      #T      #     P     ##
# # #  ## ##   ### # #### ### ## # #
# # ## #  ##  ###  ## ## ## # # ## #
# #    #       # # ### ##     ###  #
#   #     ##              #       ##
################ ################# #
# #                              # #
# # #####  ###  ##### ##### #  # # #
# # #      # #    #   #     #  # # #
# # #     #####   #   #     #### # #
# # ##### #   #   #   ##### #  #H# #
# #                              # #  
# #  ###### #  # # #### ####     # #
# #    #    #  # # #    #        # #
# #    #    #### # #### ####     # #
# #    #    #  # # #    #        # #
# #    #    #  # # #### #        # #
# #                              # #
# ### ######### ####### ########## #
#                                  #
# # ##  # ## ##### # #### ### ## # #
# # #  ## ##  ###  ## ## ## # # ## #
# # ##  # ###  # # ### #####  ###  #
#                        $         #
####################################