####################################
#H              T            P     #
# # #  ## ## ##### # #### ### ## # #
# # ## #  ##  ###  ## ## ## # # ## #
# #  # #  ###  # # ### #####  ###  #
#                                  #
# ################################ #
# #                              # #
# # #####  ###  ##### ##### #  # # #
# # #      # #    #   #     #  # # #
# # #     #####   #   #     #### # #
# # ##### #   #   #   ##### #  # # #
# #                              # #  
# #  ###### #  # # #### ####     # #
# #    #    #  # # #    #        # #
# #    #    #### # #### ####     # #
# #    #    #  # # #    #        # #
# #    #    #  # # #### #        # #
# #                              # #
# ################################ #
#                                  #
# # ##  # ## ##### # #### ### ## # #
# # #  ## ##  ###  ## ## ## # # ## #
# # ##  # ###  # # ### #####  ###  #
#                        $         #
####################################