#################################
#          #       #     P      #
# ####### ## # #  #  # ##########
#     # #    # # ### # #
##### # ###### #   ### #
#   ###     ## ### # # #
## #  #####        #   #
## ## # ## ### ##### ###
#   #      # # #  ## ###
# ######## # # ##     ##
#H#        # # ###### ##
# # ###### # #    ##  ##
# # #      # #### #   ##
# # # ####      # # # ##
#T# # ######### # # # ##
# # #         # # # # ##
# # #  # ## # # # # # ##
# # # # ## # ## # ### ##
#   #                  #
## ################ ####
## #####     #####     #
##     # # ###   ####  #########
## # #   #     #            $  #
################################
