########################
#          #       #   #
# ####### ## # #  #  # #
#     # #    # # ### # #
##### # ###### #   ### #
#   ###     ## ### # # #
## #H #####        #   #
## ## # ## ### ##### ###
#   #      # # #  ## ###
# ######## # # ##     ##
# #  *     # # ###### ##
# # ###### # #    ##  ##
# # #      # #### #   ##
# # # ####      # # # ##
# # # ######### # # # ##
# # #         # # # # ##
# # #  # ## # # # # # ##
# # # # ## # ## # ### ##
#   #   T              #
## ################ ####
## #####     #####    P#
##     # # ###   ##### #
## # #   #     #       #
########################
