#################################
#          #       #           H#
# ####### ## # #  #  # ##########
#     # #    # # ### # #
##### # ###### #   ### #
#   ###     ## ### # # #
## #  #####        #  T#
## ## # ## ### ##### ###
#   #      # # #  ## ###
# ######## # # ##     ##
# #        # # ###### ##
# # ###### # #    ##  ##
# # #      # #### #   ##
# # # ####      # # # ##
# # # ######### # # # ##
# # #         # # # # ##
# # #  # ## # # # # # ##
# # # # ## # ## # ### ##
#   #                  #
## ################ ####
## #####     #####     #
##     # # ###   ####  #########
##$# #   #     #              P#
################################
