########################
#          #       #   #
# ####### ## # #  #  # #
#     # #    # # ### # #
##### # ###### #   ### #
#   ###     ## ### # # #
## #H #####        #   #
## ## # ## ### ##### ###
#   #      # # #  ## ###
# ######## # # ##     ##
# #        # # ###### ##
# # ###### # #    ##  ##
# # #      # #### #   ##
# # # ####   *  # # # ##
#*# # ######### # # # ##
# # #         # # # # ##
# # #  # ## # # # # # ##
# # # # ## # ## # ### ##
#   #   T              #
## ################ ####
## #####     #####    P#
##     # # ###   ####  #
## # #   #     #       #
########################
