#####################################
#          #       #                #
# ########## # #  #  #  ########### #
#     # #    # # ### #  #         # #
##### # ###### #   ###  # ####### # #
#   # #     ## ### # #  # #       # #
## #  #####        #    # ######### #
## ## #### ### ##### ## #           #
#  X#      # # #  ## ## ########### #
# ######## # # ##     #             #
# #        # # #### # # ########### #
# # ###### # #    # # # #         # #
# # #      # #### #   # # #######   #
# # # ####      # # # # #         # #
# # # ######### # # # # ########### #
# # #         # # # # #             #
# # #  # ## # # # # # # ########### #
# # # # ## # ## # # # #      #      #
#   #                 S      #      #
## ################ ###      #      #
## #####   # #####    #      #      #
## #   # # # #   ###### ########### #
##   #   #     #                    #
#####################################
