########################
#          #       #   #
# ####### ## # #  #  # #
#     # #    # # ### # #
##### # ###### #   ### #
#   # #     ## ### # # #
## #X #####        #   #
## ## #### ### ##### ###
#   #      # # #  ## ###
# ######## # # ##     ##
# #        # # ###### ##
# # ###### # #    ##  ##
# # #      # #### #   ##
# # # ####      # # # ##
# # # ######### # # # ##
# # #         # # # # ##
# # #  # ## # # # # # ##
# # # # ## # ## # ### ##
#   #                  #
## ################ ####
## #####     #####    S#
##     # # ###   ##### #
## # #   #     #       #
########################
